make smth. up	-	invent, придумывать что-н.
mix smth. up	-	confuse, путать что-н., blend, смешивать что-н.
move in		- occupy a new place, въезжать (в новый дом)
move on		- двигаться дальше, переходить к чем-то новому
move out	- vacate a place, уезжать (в другой дом)
move over!		- подвинься! (воскл.)
pass away		- умирать
pass out		- faint, терять сознание
pass smth. out	- distribute, раздавать что-н.
pay smb. back	- repay, возвращать кому-н. долг
pick smth. out	- choose, выбирать что-н.
pick smth. up	- lift, подбирать что-н.
pick smb. up	- заезжать за кем-н.
piss smb. off	- annoy, раздражать кого-н.
piss off!	- отвали! (воскл.)
point smth. out	- указывать на что-н., обращать внимание
pull smth. out	- вытаскивать что-н.
put smth. away	- убирать что-н. на место
put smth. back	- класть что-н. обратно
put smth. down	- класть что-н.
put smth. in	- insert, вставлять что-н.
put smth. off	- postpone, откладывать что-н. на потом
put smth. on	- put clothes, надевать что-н.
put smth. out	- extinguish, тушить что-н. (огонь и т.п.)
put smth. up	- build, строить что-н., increase, повышать что-н. (цены и т.п.)
put up with smth.	- tolerate, мириться с чем-н.
*run across smb.	- meet by chance, встречать кого-н. неожиданно
run away		- escape, убегать
*run into smb.		- meet by chance, встречать кого-н. неожиданно
run out of smth.	- exhaust, расходовать что-н. полностью
run over		- overflow, переполняться
*run over smb.		- hit with a car, сбивать кого-н. (машиной и т.п.)
see smb. off	- go say good-bye, провожать кого-н.
set off		- start a journey, отправляться в путь
set smth. up	- устанавливать что-н., organize, организовывать что-н.
shop around	- compare prices, сравнивать цены
show smth. off	- brag, хвастать чем-н.
show up		- appear, появляться
shut up!	- замолкни! (воскл.)
sit down	- take a seat, садиться
slow down	- decelerate, снижать скорость
sort smth. out	- find a solution, решать что-н. (проблему и т.п.)
stand by	- be ready, быть наготове
*stand by smb.	- поддерживать кого-н., сохранять верность
stand up	- rise to the feet, вставать
stay away from smth.	- avoid, держаться в стороне от чего-н.
switch smth. off	- turn off, выключать что-н.
switch smth. on	- turn on, включать что-н.
*take after smb.	- resemble, быть похожим на кого-н.
take smth. back	- return, возвращать что-н. (в магазин)
take smth. off	- remove clothes, снимать что-н. (из одежды)
take off	- start to fly, взлетать
take smth. out	- extract, вынимать что-н., remove, удалять что-н.
take smb. out	- invite, приглашать кого-н. (в кино и т.п.)
take smth. over	- adopt, перенимать что-н.
take smth. up	- get interested, увлекаться чем-н. (новым хобби и т.п.)
tear smth. down	- destroy, разрушать что-н.
tear smth. up	- rip into pieces, рвать что-н. на части
think smth. over	- consider, обдумывать что-н.
throw smth. away	- get rid of, выбрасывать что-н.
throw smth. out	- get rid of, выбрасывать что-н.
throw smth. up	- vomit	извергать, что-н. при рвоте
try smth. on	- sample clothes, примерять что-н.
try smth. out	- test, тестировать что-н.
turn around	- move in rotation, поворачиваться
turn away	- avert eyes, отворачиваться
turn back	- reverse, поворачивать назад
turn smth. down	- decrease, убавлять что-н. (звук и т.п.), refuse, отказываться от чего-н.
turn sb in.     - выдавать полиции
turn in		- go to bed, ложиться спать
*turn into smth.	- change into, превращаться во что-н.
turn smth. off	- switch off, выключать что-н.
turn smth. on	- switch on, включать что-н.
turn out	- оказываться, get up, вставать (после сна)
turn smth. up	- increase, прибавлять что-н. (звук и т.п.)
turn up		- неожиданно появляться
use smth. up	- exhaust, расходовать что-н. полностью
wake up		- stop sleeping, просыпаться
walk around	- wander, гулять
walk away	- leave, уходить
walk in		- входить без разрешения
walk out	- leave, выходить
watch out!	- осторожнее! (воскл.)
work smth. out	- calculate, решать что-н., understand, понимать что-н.
write smth. down	- note, записывать что-н.