buzzword - модное слово
hallmark - признак
convey - собрать
inconsequential - несущественный
rationale - логическое объяснение, разумное обоснование
stand him - терпеть его
vastly - чрезвычайно
favor - благоприятствовать
encroachment - вторжение
burden - ноша, бремя
inference - умозаключение
somewhat - отчасти, слегка
mutual - взаимный
misgiving - опасение
fatigue - усталость
overriding - главный, первостепенный
sidestep - обойти
occasionally - иногда, изредка
eventually - в конце концов
elaborate - детально разрабатывать, уточнять
testify - свидетельствовать, давать показания
stem - ствол, стебель; происходить
emerge - возникать, всплывать
recount - рассказывать, излагать подробно
outset - начало, завязка, исток
perpetuate - увековечить
grip - схватывать, схватывание
rudimentary - элементарный, зачаточный
secure - охранять, закрепить, обеспечить, гарантировать
expedience - целесообразность, выгода
beaver board - древесно-волоконная плита
foster - питать (чувство), воспитывать, лелеять (надежду)
foci - очаги
deliberately - умышленно, обдуманно
recurring - повторяющийся
twist - изгиб, поворот
treatise - трактат
premise - предпосылка
fertilization -удобрение, оплодотворение
pollination - опыление
pollen - пыльца
astonishing - потрясающий
contrivance - ухищрение, затея, план, приспособление
adhere - приставать, прилирать
offspring - потомок
evolve - развиваться, эволюционировать
conviction - убеждение