inference - умозаключение
outset - начало, завязка, исток
adhere - приставать, прилипать, придерживаться
excrete - выделять
abandon - бросать, отказываться
flock - стадо, стая, группа (людей)
stock - род, семья, запас, акции
possess - обладать способностями, обладать возможностями, владеть
extinction - тушение, вымирание
concern - проблема, вопрос, дело
extirpation - уничтожение, удаление с корнем
deterioration - ухудшение (состояния), износ
succumb to - поддаться, стать жертвой
succour - поддерживать, оказывать военную помощь
contamination - загрязнение, заражение, порча
feeble - немощный, хилый
pervasive - всеобъемлющий
undertake - взять обязательства, предпринимать
strive - стараться
implication - следствие, вовлечение
deliverable - комплектующий узел, подлежащий сдаче
substantial - значительный, существенный, солидный
sloppy - неряшливый, небрежный
engage - занимать, увлекать, привлекать
condescending - снисходительный
be smitten with - быть охваченным (страстью), быть без ума (от чего-либо)
ascendancy - доминирующее влияние, господство
bellicose - воинственный, агрессивный, драчливый
incline - наклоняться, быть склонным (к чему-либо)
ascribe - относить на счет, приписывать
clerical - церковный, офисный, канцелярский
disengage - освобождать, отсоединять
disentangle - освобождать, распутывать
superstition - суеверие, предрассудок
outline - очертание, схема, набросок, эскиз 
outlines - основные положения
bring out - выявлять, обнаруживать 
educe - выявлять, обнаруживать,  выделять (хим.)
employ - применять, использовать
work out - вычислять, решать (задачу), упражняться, делать зарядку
arise - возникать, появляться
treatment - обращение, обработка, трактовка, лечение
roam - странствовать, скитаться, бродить
semblance - подобие, внешний вид
preserve - заповедник, заказник
nurse - обхаживать, лечить, выращивать, поливать (растение)
arboretum - дендрарий, питомник
reclamation - протест, аппелляция, мелиорация
any more - как и, не больше чем
consign - вверять, назначать, предназначать
reclaim - возвращать, требовать обратно
abundant - обильный, изобилующий, имеющийся в избытке
carrion - падаль, труп
yet - еще, до сих пор, однако
fecund - плодородный, плодовитый
disperse - рассеивать, распространять, разбрасывать, распылять
extent - пространство, степень, пределы
baseline - отправная точка, базовый уровень, стандарт
culling - отбор, отбраковка
game - объект преследования, дичь
sustain - поддерживать, способствовать
drive out, dismiss - выгонять
thoughtful - чуткий, внимательный, думающий
ranger - бродяга, лесник, амер. полицейский, амер. десантник
afflict - причинять боль, беспокоить
statement - утверждение, официальный отчет, заявление
primitive - первобытный, примитивный, первозданный
vignette - зарисовка
logging - регистрация, лесозаготовки
livestock - скот
graze - пасти скот
abruptly - вдруг, внезапно, резко
outbreak - вспышка, восстание
ungulate - копытное животное
vertebrate - позвоночное (животное)
inadvertently - нечаянно, неосторожно, неумышленно
introduce - вводить, включать, знакомить
trampling - вытаптывание
camping ground - кемпинг
objective - цель, задание, тех. требование
utmost - предел, высшая степень
overtake - догонять, наверстывать
superintendent - надзиратель, управляющий
supervisor - инспектор, надсмотрщик, контролер
grade - ставить оценку, классифицировать
incentive - поощрение, стимул
appreciation - признательность, положительная оценка, благоприятный отзыв
accountability - ответственность, подотчетность
emphasis - ударение, упор
perpetuate - увековечивать
spring - пружина, прыжок, весна, (внезапно) появляться
translation - преобразование, изменение
intact - нетронутый, неповрежденный
laissez-faire - невмешательтство
tenable - разумный
account - счет, мнение, оценка, доклад, отчет
crucial - ключевой, критический
hold - держать, полагать, считать
hammer out - ковать, разрабатывать, продумывать
plausible - благовидный, правдоподобный, приемлемый
decree - декрет, постановление, решение
plague - мор, эпидемия, чума
spatial - пространственный, территориальный
outlie - находиться снаружи
on pain of death - под страхом смерти
quarrel - ссора
stray - отбившийся от стада, заблудившийся
syndic - глава местного самоуправления, чиновник
surveillance - надзор, наблюдение
condemn - осуждать, приговаривать, обрекать
appointed - назначенный заранее, определенный
herb - трава, лекарственное растение, нарк. трава
hoist - поднимать (лебедкой)
pulley - блок, ворот
vile - гадкий, гнусный, подлый
contagion - зараза, инфекция, пагубное влияние
extortion - вымогательство
prompt - исполнительный, расторопный
obedience - повиновение, подчинение, послушание
sentinel - часовой, караульный
in respect - применительно
compelled - вынужденный, подчиненный
conceal - скрывать, утаивать, умалчивать
lock up - запирать
notwithstanding - несмотря на, вопреки
town hall - мэрия, ратуша
roll call - перекличка, сигнал сбора
course - курс, ход, течение
physician - врач, доктор, целитель, лекарь, терапевт
confessor - духовник, исповедник
relation - отношение, изложение фактов, повествование, предоставление информации
suspend - приостанавливать, временно отстранять
seal - опечатывать, запечатывать, уплотнять, герметизировать
set alight - запалить
forsake - покидать
bespeak - обговаривать, заказывать заранее
leap - прыгать
lend - одалживать, ссужать
sew - шить
shear - cтричь (овец)
expository - объяснительный, пояснительный
lend itself - приспосабливаться, прилаживаться
assortment - ассортимент, подбор
amend - исправлять, совершенствовать, вносить поправки
etching - гравюра
recollection - воспоминание, размышление
reward - поощрять, награждать
imposing - впечатляющий, внушительный
look over - тщательно изучить
landmark - поворотный пункт, веха
flounder - испытывать серьезные трудности
disguise - менять внешность, маскировать
climax - наивысшая точка, кульминация, оргазм
take on - браться (за дело)
tug - тащить, буксировать
provision - обеспечение, постановление
facilities - удобства, льготы
inherent - присущий, врожденный
in and of itself - вообще, само по себе
content - содержание, довольный, удовлетворенный
conscience - сознание, совесть
turn in - выдавать (полиции)
stage - стадия, ступень, фаза
pat - подходящий, уместный, стандартный
overarching - всеохватыващий, всеобъемлющий
persuasive - убедительный
variety - многообразие, разнообразие, вариант
convention - соглашение, собрание, съезд
bargain - торговое соглашение, сделка, выгодная покупка
slip away - ускользать
pinpoint - заострить внимание (на чем-либо)
option - дополнение, альтернатива, вариант
fiction - фантазия, байка, художественная литература, беллетристика, фикция
consequtive - упорядоченный
serial - серийный, периодический, последовательный
device - устройство, способ, метод
heighten - повышать, усиливать
get off - отправляться, начинать
passage - прохождение, переход, проезд, течение (событий, времени)
outrage - возмущение, гнев, негодование
run mad - сходить с ума
drown - тонуть, топить
build - строить, возводить, нарастать
head - возглавлять, направлять(ся)
plot - сюжет, план, интрига
meantime - тем временем, между тем, пока
challenge - ставить под сомнение, оспаривать, бросать вызов
seize - понять, уловить, ухватить
explication - пояснение, толкование
experience - опыт, испытывать
squash - размягченная масса, кашица
hum - жужжать, хмыкать, мурлыкать, петь без слов
knee socks - носки до колена, гольфы
saddle shoes - двухцветные кожаные туфли
plaid - в клетку, клетчатый, пледовый
ruffle - оборка, кружевая манжетка, тасовка карт, барабанная дробь
neat - четкий, аккуратный, изящный
curl - локон, завиток, водоворот
set smb. apart - выделять (на фоне других)
valley - долина, впадина, низина
groove - прорывать (пазы, канавки)
ditch - канава, ров, канал
grind - молоть, шлифовать
alkaline - солонцеватый, щелочной
windbreak - бурелом, ограда для защиты от ветра
stand - стенд, стойка, прилавок, лесопосадки
signpost - указатель, веха
map out - планировать
recognition - распознавание, осознание
ominious - предсказывающий, грозный, зловещий
gleam - светиться, мерцать
shoo - вспугивать, прогонять
brood - нависать (об облаках, тьме), тяготить (о заботах)