set alight - запалить
forsake - покидать
bespeak - обговаривать, заказывать заранее
leap - прыгать
lend - одалживать, ссужать
sew - шить
shear - cтричь (овец)
expository - объяснительный, пояснительный
lend itself - приспосабливаться, прилаживаться
assortment - ассортимент, подбор
diffusion - распространение, взаимопроникновение
amend - исправлять, совершенствовать, вносить поправки
etching - гравюра
recollection - воспоминание, размышление
reward - поощрять, награждать
imposing - впечатляющий, внушительный
look over - тщательно изучить
landmark - поворотный пункт, веха
flounder - испытывать серьезные трудности
climax - наивысшая точка, кульминация, оргазм
take on - браться (за дело)
tug - тащить, буксировать
provision - обеспечение, постановление
facilities - удобства, льготы
inherent - присущий, врожденный
in and of itself - вообще, само по себе
content - содержание, довольный, удовлетворенный
conscience - сознание, совесть
turn in - выдавать (полиции)
stage - стадия, ступень, фаза
pat - подходящий, уместный, стандартный
overarching - всеохватывающий, всеобъемлющий
persuasive - убедительный
variety - многообразие, разнообразие, вариант
convention - соглашение, собрание, съезд
bargain - торговое соглашение, сделка, выгодная покупка
slip away - ускользать
pinpoint - заострить внимание (на чем-либо)